@size=(10,10)
@name=Level 1
@viewfield=1

P $$$$$$ $;
$ +      $;
  $ $$$$  ;
 $$    $ $;
  $ $$   $;
$ $$$$$$ $;
$      $  ;
  $ $$ $$ ;
 $$ $$$$$ ;
 $     E$ ;
