@10,10

P $$$$$$ $;
$        $;
  $ $$$$  ;
 $$    $ $;
  $ $$   $;
$ $$$$$$ $;
$      $  ;
  $ $$ $$ ;
 $$ $$$$$ ;
 $  G  E$K;
